1111111111
10001000C1
100C001101
1P0011E001
1111111111
