1111111111
1000100001
100C001101
1P0011E001
1111111111
